北京大兴国际机场	北京	民航机场
厦门高崎国际机场	厦门	民航机场
香港国际机场	香港	民航机场
澳门国际机场	澳门	民航机场
北京首都国际机场	北京	民航机场
哈尔滨太平国际机场	哈尔滨	民航机场
西安咸阳国际机场	西安	民航机场
合肥新桥国际机场	合肥	民航机场
三亚凤凰国际机场	三亚	民航机场
金边国际机场	金边	民航机场
新加坡樟宜国际机场	新加坡	民航机场
上海浦东国际机场	上海	民航机场
东京成田国际机场	东京	民航机场
巴黎戴高乐国际机场	巴黎	民航机场
青岛胶东国际机场	青岛	民航机场
洛杉矶国际机场	洛杉矶	民航机场
济南遥墙国际机场	济南	民航机场
广州白云国际机场	广州	民航机场
武汉天河国际机场	武汉	民航机场
泉州晋江国际机场	泉州	军民合用
桂林两江国际机场	桂林	民航机场
深圳宝安国际机场	深圳	民航机场
法兰克福国际机场	法兰克福	民航机场
旧金山国际机场	旧金山	民航机场
台北松山机场	台北	民航机场
台北桃园机场	台北	民航机场
首尔仁川国际机场	首尔	民航机场