北京大兴国际机场	PKX	
厦门高崎国际机场	XMN	
香港国际机场	HKG	
澳门国际机场	MFM	
北京首都国际机场	PEK	
哈尔滨太平国际机场	HRB	
西安咸阳国际机场	XIY	
合肥新桥国际机场	HFE	
三亚凤凰国际机场	SYX	
金边国际机场	PNH	
新加坡樟宜国际机场	SIN	
上海浦东国际机场	PVG	
东京成田国际机场	NRT	
巴黎戴高乐国际机场	CDG	
青岛胶东国际机场	TAO	
洛杉矶国际机场	LAX	
济南遥墙国际机场	YNA	
广州白云国际机场	CAN	
武汉天河国际机场	WUH	
泉州晋江国际机场	JJN	
桂林两江国际机场	KWL	
深圳宝安国际机场	SZX	
法兰克福国际机场	FRA	
旧金山国际机场	SFO	
台北松山机场	TSA	
台北桃园机场	TPE	
首尔仁川国际机场	ICN